11111111111111111111111111111111
10C0C0C000010000C000C0000C000C01
1011101111010111101110100C000C01
1011101111010111101110100C000C01
10000000000P00000000001000000001
10111010111111101011101001111111
10C0001C000E00001000C010010001C1
11111010111111101011111001010101
1C000000000C0000000C000001010101
10111011110101111011101000010001
11111111111111111111111111111111