11111111111111111111111111111111
10C0C0C000010000C000C0000C000C01
101110X1110X0111101110100C000C01
101110X1110X0111101110100C0X0C01
10000000000P000X0000001000000001
101110101111111010111010011X1111
10C0001C000E00001000C01X010001C1
11111000111111101011111001010101
1C0000X0000C0000000C0000X1010101
10111011110101111011101000010001
11111111111111111111111111111111