1111111111
1000000C01
100001X001
1PEC000001
100000XC11
1111111111