1111111111
1000000C01
1000010001
1PEC000001
1000011C11
1111111111