11111111111111111111111
10C0C0C000010000C000C01
10100X111101011110X1101
10111011110101111001101
10000000000P00000000001
1000X010111111X01011101
10C0001C000E00001000C01
11111111111111111111111