11111111111111111111111
10C0C0C000010000C000C01
10111011110101111011101
10111011110101111011101
10000000000P00000000001
10111010111111101011101
10C0001C000E00001000C01
11111111111111111111111